//MAP CONVERTED BY dmm2tgm.py THIS HEADER COMMENT PREVENTS RECONVERSION, DO NOT REMOVE
"aY" = (
/obj/structure/flora/grass/jungle/b{
	icon_state = "grassb2"
	},
/turf/open/floor/plating/dirt/jungle/dark,
/area/space)
"cg" = (
/obj/structure/flora/junglebush/large,
/turf/open/floor/plating/grass/jungle,
/area/space)
"eN" = (
/obj/structure/flora/tree/jungle{
	icon_state = "tree3"
	},
/turf/open/floor/plating/grass/jungle,
/area/space)
"gg" = (
/obj/item/stack/sheet/metal,
/turf/open/floor/plating/grass/jungle,
/area/space)
"iB" = (
/obj/item/stack/tile/plasteel,
/turf/open/floor/plating/grass/jungle,
/area/space)
"jm" = (
/obj/structure/flora/junglebush/large{
	icon_state = "bush2"
	},
/turf/open/floor/plating/grass/jungle,
/area/space)
"jJ" = (
/turf/template_noop,
/area/space)
"mT" = (
/obj/structure/flora/junglebush,
/turf/open/floor/plating/dirt/jungle/dark,
/area/space)
"nd" = (
/obj/structure/flora/junglebush/c{
	icon_state = "bushb1"
	},
/turf/open/floor/plating/grass/jungle,
/area/space)
"qE" = (
/obj/item/stack/sheet/plasteel,
/turf/open/floor/plating/dirt/jungle,
/area/space)
"rU" = (
/obj/item/stack/cable_coil/cut/red,
/turf/open/floor/plating/dirt/jungle,
/area/space)
"sd" = (
/obj/structure/flora/tree/jungle/small,
/turf/open/floor/plating/grass/jungle,
/area/space)
"tZ" = (
/obj/item/stack/rods,
/turf/open/floor/plating/dirt/jungle/dark,
/area/space)
"xM" = (
/obj/structure/flora/junglebush/c,
/turf/open/floor/plating/grass/jungle,
/area/space)
"yk" = (
/obj/structure/flora/rock/pile/largejungle,
/turf/open/floor/plating/grass/jungle,
/area/space)
"FI" = (
/obj/structure/flora/junglebush/b,
/turf/open/floor/plating/grass/jungle,
/area/space)
"Gb" = (
/obj/item/stack/rods/ten,
/turf/open/floor/plating/dirt/jungle/dark,
/area/space)
"Gj" = (
/obj/item/stack/rods,
/turf/open/floor/plating/grass/jungle,
/area/space)
"GE" = (
/obj/item/stack/tile/plasteel,
/turf/open/floor/plating/dirt/jungle,
/area/space)
"If" = (
/obj/structure/flora/grass/jungle,
/turf/open/floor/plating/dirt/jungle,
/area/space)
"IR" = (
/obj/structure/flora/grass/jungle,
/turf/open/floor/plating/grass/jungle,
/area/space)
"JX" = (
/turf/open/floor/plating/dirt/jungle/wasteland,
/area/space)
"KA" = (
/obj/item/stack/cable_coil/red,
/turf/open/floor/plating/grass/jungle,
/area/space)
"KS" = (
/obj/structure/flora/grass/jungle/b{
	icon_state = "grassa4"
	},
/turf/open/floor/plating/grass/jungle,
/area/space)
"NV" = (
/obj/structure/flora/junglebush/c{
	icon_state = "busha2"
	},
/turf/open/floor/plating/dirt/jungle/dark,
/area/space)
"QG" = (
/obj/item/stack/sheet/metal/ten,
/turf/open/floor/plating/dirt/jungle/dark,
/area/space)
"Rv" = (
/obj/structure/flora/grass/jungle/b{
	icon_state = "grassb3"
	},
/turf/open/floor/plating/grass/jungle,
/area/space)
"Se" = (
/obj/structure/flora/rock/jungle{
	icon_state = "rock5"
	},
/obj/item/stack/sheet/metal,
/turf/open/floor/plating/dirt/jungle/dark,
/area/space)
"Un" = (
/obj/structure/flora/rock/jungle{
	icon_state = "rock3"
	},
/turf/open/floor/plating/dirt/jungle/dark,
/area/space)
"ZF" = (
/turf/open/floor/plating/dirt/jungle,
/area/space)
"ZI" = (
/turf/open/floor/plating/grass/jungle,
/area/space)
"ZV" = (
/turf/open/floor/plating/dirt/jungle/dark,
/area/space)

(1,1,1) = {"
ZI
ZI
ZI
ZI
ZI
KS
ZI
ZI
ZV
ZV
ZF
ZF
ZF
Se
ZF
ZF
ZF
ZF
ZF
ZF
ZF
ZF
ZF
ZF
ZF
ZF
ZF
ZF
ZF
ZF
ZF
ZF
ZF
ZV
ZV
"}
(2,1,1) = {"
ZI
ZI
eN
ZI
ZI
ZI
ZI
nd
ZI
ZV
ZF
ZF
ZF
iB
NV
GE
ZF
ZF
ZF
ZF
ZF
ZF
ZF
ZF
ZF
ZF
ZF
ZF
ZF
ZF
ZF
ZF
ZV
ZV
ZI
"}
(3,1,1) = {"
ZI
ZI
gg
ZI
Rv
ZI
ZI
ZI
ZF
ZV
ZF
ZF
ZF
ZF
ZV
ZF
ZF
ZF
ZF
ZF
ZF
ZF
ZF
ZF
ZF
ZF
ZF
ZF
ZF
ZF
ZF
ZV
ZV
ZV
IR
"}
(4,1,1) = {"
ZI
ZI
ZI
ZI
ZI
ZI
ZF
ZV
ZV
ZV
ZF
ZF
ZF
ZF
ZF
ZF
ZF
ZF
ZF
ZF
ZF
ZF
ZF
ZF
ZF
ZF
ZF
ZF
ZF
ZF
ZF
ZV
ZI
jm
ZI
"}
(5,1,1) = {"
ZI
ZI
ZI
cg
ZI
ZF
ZV
ZV
ZF
ZF
ZF
ZF
ZF
ZF
ZF
ZF
ZF
ZF
ZF
ZF
ZF
ZF
ZF
ZF
ZF
ZF
ZF
ZF
ZF
ZF
ZF
ZV
ZV
ZI
ZI
"}
(6,1,1) = {"
ZI
ZI
KA
ZI
ZI
QG
ZV
ZF
ZF
ZF
ZF
ZF
ZF
ZF
ZF
ZF
ZF
ZF
ZF
ZF
ZF
ZF
ZF
ZF
ZF
ZF
ZF
ZF
ZF
ZF
ZF
ZF
ZV
ZV
FI
"}
(7,1,1) = {"
ZI
yk
ZI
ZI
ZV
ZV
ZF
ZF
ZF
ZF
ZF
ZF
ZF
ZF
ZF
ZF
ZV
ZV
ZV
ZF
ZF
ZF
ZF
ZF
ZF
If
ZF
ZF
ZF
ZF
ZF
ZF
ZV
ZV
ZV
"}
(8,1,1) = {"
ZI
ZI
ZI
ZV
ZV
ZF
ZF
ZF
ZF
ZF
ZF
ZF
ZF
ZF
ZF
ZF
ZV
JX
ZF
ZV
ZF
ZF
ZF
ZF
ZF
ZF
ZF
ZF
ZF
ZF
qE
ZV
JX
ZI
jJ
"}
(9,1,1) = {"
ZI
ZI
mT
ZV
ZV
ZF
ZF
ZF
ZF
ZF
ZF
ZF
ZF
ZF
ZF
ZF
ZV
JX
ZV
ZF
ZF
ZF
ZF
ZF
ZF
ZF
ZF
ZF
ZF
ZF
ZV
JX
JX
ZF
jJ
"}
(10,1,1) = {"
ZI
ZI
ZI
ZV
sd
ZF
rU
ZF
ZF
ZF
ZF
ZF
ZF
ZF
ZF
ZF
ZF
JX
ZV
ZF
ZF
ZF
ZF
ZF
ZF
ZF
ZF
ZF
ZF
ZF
ZV
JX
ZV
ZF
ZI
"}
(11,1,1) = {"
IR
gg
ZI
ZV
ZV
ZF
ZF
ZF
ZF
ZF
ZF
ZF
ZF
ZF
ZF
ZF
ZV
JX
ZV
ZV
ZV
ZF
ZF
JX
ZF
ZF
ZF
ZF
ZF
ZF
JX
JX
ZF
ZF
ZI
"}
(12,1,1) = {"
ZI
ZI
ZV
ZV
ZV
ZF
ZF
ZF
ZF
ZF
ZF
ZF
ZF
ZF
ZF
ZF
ZV
ZV
JX
ZV
ZV
JX
JX
ZF
JX
JX
ZF
ZF
ZF
ZV
JX
ZF
ZF
ZF
ZI
"}
(13,1,1) = {"
ZI
ZI
ZI
Gb
ZV
ZF
ZF
ZF
ZF
ZF
ZF
ZF
ZF
ZF
ZF
ZV
ZV
ZV
ZV
JX
JX
JX
ZF
ZF
ZF
ZF
ZF
ZF
ZV
JX
JX
ZV
ZF
ZF
ZI
"}
(14,1,1) = {"
ZI
ZI
ZV
ZV
gg
ZF
ZF
ZF
ZF
ZF
ZF
ZF
ZF
ZF
ZF
ZF
ZV
ZV
JX
ZV
ZV
ZF
ZF
ZF
ZF
ZF
ZF
ZV
JX
JX
ZV
ZF
ZF
ZF
ZI
"}
(15,1,1) = {"
ZI
ZV
ZV
ZI
ZV
ZF
ZF
ZF
ZF
ZF
ZF
ZF
ZF
ZF
ZF
ZF
ZV
ZV
JX
JX
ZV
ZV
ZF
ZF
ZF
ZF
ZF
ZV
JX
ZF
ZV
ZF
ZF
ZF
ZI
"}
(16,1,1) = {"
ZV
ZV
ZF
ZF
ZF
ZF
ZF
ZF
ZF
ZF
ZF
ZF
ZF
ZF
ZF
ZF
ZV
ZV
ZV
JX
JX
ZV
ZF
ZF
ZF
ZF
ZF
JX
JX
ZV
ZF
ZF
ZF
ZF
ZI
"}
(17,1,1) = {"
xM
ZF
ZF
ZF
ZF
ZF
ZF
ZF
ZF
ZF
ZF
ZF
ZF
ZF
ZF
ZF
ZV
ZV
ZV
ZV
JX
ZV
ZV
ZF
ZF
ZF
ZV
JX
ZV
ZF
ZF
ZF
ZF
ZF
ZI
"}
(18,1,1) = {"
Gj
ZF
ZF
ZF
ZF
ZF
ZF
ZF
ZF
ZF
ZF
ZF
ZF
ZF
ZF
ZF
ZF
ZV
ZV
ZV
ZV
ZV
ZV
ZF
ZF
ZF
ZV
ZV
ZF
ZF
ZF
ZF
ZF
ZF
ZI
"}
(19,1,1) = {"
ZI
ZF
ZF
ZF
ZV
Un
ZF
ZF
ZF
ZF
ZF
ZF
ZF
ZF
ZF
ZF
ZF
ZF
ZV
ZV
ZF
ZF
ZF
ZF
ZF
ZF
ZF
ZF
ZF
ZF
ZF
ZF
ZF
ZF
ZI
"}
(20,1,1) = {"
ZV
ZV
ZV
Gj
ZV
ZV
ZF
ZF
ZF
ZF
ZF
ZF
ZF
ZF
ZF
ZF
ZF
ZF
ZF
ZF
ZF
ZF
ZF
ZF
ZF
ZF
ZF
ZF
ZF
ZF
ZF
ZF
ZF
ZF
ZI
"}
(21,1,1) = {"
ZV
ZI
ZF
ZV
ZV
ZV
ZF
ZF
ZF
ZF
ZF
ZF
ZF
ZF
ZF
ZF
ZF
ZF
ZF
ZF
ZF
ZF
ZF
ZF
ZF
ZF
ZF
ZF
ZF
ZF
ZF
ZF
ZI
ZF
Gj
"}
(22,1,1) = {"
ZV
Gj
ZI
ZI
ZF
ZF
ZF
ZF
ZF
ZF
ZF
ZF
ZF
ZF
ZF
ZF
ZF
ZF
ZF
ZF
ZF
ZF
ZF
ZF
ZF
ZF
ZF
ZF
ZF
ZF
ZF
ZF
ZF
ZV
ZI
"}
(23,1,1) = {"
ZF
ZV
ZF
ZI
ZF
ZF
ZI
ZI
ZI
ZV
ZV
ZI
ZI
Gj
ZV
ZI
ZF
ZF
ZF
ZF
ZF
ZF
ZF
ZF
ZF
ZF
ZF
ZF
ZF
ZF
ZF
ZF
Un
ZV
ZV
"}
(24,1,1) = {"
ZV
ZI
Gj
ZI
ZF
ZI
ZI
ZI
ZI
ZV
ZI
ZI
ZV
ZV
ZV
ZV
ZI
ZI
ZI
ZI
ZV
aY
ZV
ZI
ZI
ZI
ZF
ZI
ZI
ZI
tZ
ZV
ZV
ZV
ZV
"}
(25,1,1) = {"
ZV
Gj
ZI
ZI
ZI
ZI
ZI
ZI
ZI
ZI
ZI
ZI
ZI
ZI
ZI
ZI
ZI
ZI
Gj
ZV
ZV
ZV
ZV
ZV
ZV
ZF
ZF
ZV
ZV
ZI
ZV
ZF
ZV
ZV
ZI
"}
